9999999999999999999999999999999999999999999999999999999999999999999999999999999999999999999999333333
9999999999999999999999999999999999999999999999999999999999999999999999999999999999999999999999344443
1111111111111111111111111111111111111111111111111111111111111111111111111111111111111111111199345543
1111111111111111111111111111111111111111111111111111111111111111111111111111111111111111111199345543
1111111111111111111111111111111111111111111111111111111111111111111111111111111111111111111199344443
1111111111111111111111111111111111111111111111111111111111111111111111111111111111111111111199333333
1111111111111111111111111111111111111111111111111111111111111111111111111111111111111111111199999999
1111111111111111111111111119222111111111111111111111111111111111111111111111111111111111111199999999
1111111111111111111111111119222111111111111111111111111111111111111111111111111111111111111111111119
1111111111111111111111111119222111111111111111111111119221111111111111111111111111111111111111111119
1111111111111111111111111119222111111111111111111111119221111111111111111111111111111111111111111119
1111111111111111111111192222999222211111111111111111119221111111111111111111111111111111111111111119
1111111111111111111111192222999222211111111111111111119221111111111111111111111111111111111111111119
1111111111111111111111192222999222211111111111111111119221111111111111111111111111111111111111111119
1111111111111111111111199999222999911111111111111111119221111111111111111111111111111111111111111119
1111111111111111111111199999222999911111111111111111119221111111111111111111111111111111111111111119
1111111111111111111111111119222111111111111111111111119221111111111111111111111111111111111111111119
1111111111111111111111111119222111111111111111111111119221111111111111111111111111111111111111111119
1111111111111111111111111119999111111111111111111111119221111111111111111111111111111111111111111119
1111111111111111111111111119999111111111111111111111119221111111111111111111111111111111111111111119
1111111111111111111111111111111111111111111111111111119221111111111111111111111111111111111111111119
1111111111111111111111111111111111111111111111111111119221111111111111111111111111111111111111111119
1111111111111111111111111111111111111111111111111111119221111111111111111111111111111111111111111119
1111111111111111111111111111111111111111111111111111119221111111111111111111111111111111111111111119
1111111111111111111111111111111111111111111111111111119221111111111111111111111111111111111111111119
1111111111111111111111111111111111111111111111111111119221111111111111111111111111111111111111111119
1111111111111111111111111111111111111111111111111111119991111111111111111111111111111111111111111119
1111111111111111111111111111111111111111111111111111119991111111111111111111111111111111111111111119
1111111111111111111111111119221111111111111111111111111111111111111111111111111111111111111111111119
1111111111111111111111111119221111111111111111111111111111111111111111111111111111111111111111111119
1111111111111111111111111119221111111111111111111111111111111111111111111111111111111111111111111119
1111111111111111111111111119221111111111111111111111111111111111111111111111111111111111111111111119
1111111111111111111111111119221111111111111111111111111111111111111111111111111111111111111111111119
1111111111111111111111111119221111111111111111111111111111111111111111111111111111111111111111111119
1111111111111111111111111119221111111111111111111111111111111111111111111111111111111111111111111119
1111111111111111111111111119221111111111111111111111111111111111111111111111111111111111111111111119
1111111111111111111111111119221111111111111111111111111111111111111111111922222222222222221111111119
1111111111111111111111111119221111111111111111111111111111111111111111111922222222222222221111111119
1111111111111111111111111119221111111111111111111111111111111111111111111999999999999999991111111119
1111111111111111111111111119221111111111111111111111111111111111111111111999999999999999991111111119
1111111111111111111111111119991111111111111111111111111111111111111111111111111111111111111111111119
1111111111111111111111111119991111111111111111111111111111111111111111111111111111111111111111111119
1111111111111111111111111111111111111111111111111111111111111111111111111111111111111111111111111119
1111111111111111111111111111111111111111111111111111111111111111111111111111111111111111111111111119
1111111111111111111111111111111111111111111111111111111111111111111111111111111111111111111111111119
1111111111111111111111111111111111111111111111111111111111111111111111111111111111111111111111111119
1111111111111111111111111111111111111111111111111111111111111111111111111111111111111111111111111119
1111111111111111111111111111111111111111111111111111111111111111111111111111111111111111111111111119
1111111111111111111111111111111111111111111111111111111111111111111111111111111111111111111111111119
1111111111111111111111111111111111111111111111111111111111111111111111111111111111111111111111111119
1111111111111111111111111111111111111111111111111111111111111111111111111111111111111111111111111119
1111111111111111111111111119222111111111111111111111111111111111111111192221111111111111111111111119
1111111111111111111111111119222111111111111111111111111111111111111111192221111111111111111111111119
1111111111111111111111111119222111111111111111111111111111111111111111192221111111111111111111111119
1111111111111111111111111119222111111111111111111111111111111111111111192221111111111111111111111119
1111111111111111111111192222999222211111111111111111111111111111111922229992222111111111111111111119
1111111111111111111111192222999222211111111119222222222221111111111922229992222111111111111111111119
1111111111111111111111192222999222211111111119222222222221111111111922229992222111111111111111111119
1111111111111111111111199999222999911111111119999999999991111111111999992229999111111111111111111119
1111111111111111111111199999222999911111111119999999999991111111111999992229999111111111111111111119
1111111111111111111111111119222111111111111111111111111111111111111111192221111111111111111111111119
1111111111111111111111111119222111111111111111111111111111111111111111192221111111111111111111111119
1111111111111111111111111119999111111111111111111111111111111111111111199991111111111111111111111119
1111111111111111111111111119999111111111111111111111111111111111111111199991111111111111111111111119
1111111111111111111111111111111111111111111111111111111111111111111111111111111111111111111111111119
1111111111111111111111111111111111111111111111111111111111111111111111111111111111111111111111111119
1111111111111111111111111111111111111111111111111111111111111111111111111111111111111111111111111119
1111111111111111111111111111111111111111111111111111111111111111111111111111111111111111111111111119
1111111111111111111111111111111111111111111111111111111111111111111111111111111111111111111111111119
1111111111111111111111111111111111111111111111111111111111111111111111111111111111111111111111111119